#############################################################################################################################################
#...........#...#.........#...........................#...#.....#.................#...#.......#.......#...#.........#.....#...........#...#.#
#.#.#######.#.#.#.#######.#.#############.#######.###.###.#####.#.#############.#.###.#.#####.#.#####.#.#.#.###.###.#.###.#.###.#####.#.#.#.#
#.#.......#.#.#.#.#...#.#...#.......#...#.......#...#...#.....#.......#.#.......#...#...#.....#.#.#...#.#.#...#...#...#...#...#.....#...#...#
#########.#.#.#.#.###.#.#####.#####.#.#.###########.###.###.#.#######.#.#.#########.#.#####.###.#.#.#####.###.###.###########.#####.#########
#.........#.#.#.#.....#...#...#...#.#.#.#.......#.....#.#...#...#.......#.#.......#...#...#...#.#.#.#.....#...#.#.....#.....#.....#.........#
#.#.#########.#.#####.#.#.#.###.###.#.#.#.#####.#.###.#.#.#####.#########.#.#####.#######.###.#.#.#.#.###.#.###.#####.#.###.#####.#########.#
#.#.#.......#.#.....#.#.#.#.#...#.....#...#.....#.#...#...#...#.#...#.....#.#...#.......#.......#...#.#.#.#.#.......#.#.#...#.#...#.......#.#
#.###.#####.#.###.#.#.#.###.#.###.###.#########.###.#######.#.#.#.#.#.###.#.#.#.#######.#.#######.###.#.#.#.#.#######.#.#.#.#.#.###.#.#####.#
#.#...#...#.....#.#.#.#...#.#.......#.#.......#...#...#...#.#...#.#.#.#...#...#.......#.#.#...#.......#...#...#.....#...#.#...#...#.#...#...#
#.#.###.#######.#.#.#.###.#.#######.###.#####.###.###.#.###.#####.#.#.#.#######.#######.###.#.#######.#####.###.###.###.#.###.###.###.###.###
#...#.....#...#.#.#.#...#.#.......#.#...#.#...#.#...#.#...........#.#.#...#...#.#.....#.....#.......#.#.....#...#.#...#.#.#...#...#...#...#.#
#.#######.#.#.###.#####.#.#######.###.###.#.#.#.###.#.#.###########.#.#####.###.#.###.#########.###.###.#####.#.#.###.#.#.#.###.###.#.#.###.#
#.......#.#.#...#.....#.#...#...#.........#.#.#.......#...#...#...#...#.........#...#...#.....#.#.#.#...#...#.#.#...#.#.#.#...#...#.#.#.#.#.#
#######.#.#.###.#.###.#.#.#.###.###########.#.#############.#.#.#.###.#.###########.###.#.###.#.#.#.#.#####.#.#####.#.###.#######.#.#.#.#.#.#
#.........#.#...#...#.#.#.#...#...#.........#.#.#...........#...#.#...#.#.......#...#.#...#.#.#...#.#.....#.#.....#.#...#.........#.#.#.#...#
###########.#.#####.#.#.#.###.#.###.#########.#.#.###############.#####.#.#####.#.###.#####.#.#.###.#####.#.#####.#.###.#.#########.###.###.#
#.....#.....#...#...#.....#...#...#.#.....#.....#.#.........#...#.#.....#.....#...#.#.#.....#.#...#...#.....#.....#.....#...#.......#...#...#
#.###.#.#######.#.#######.#.#####.#.#.#####.#####.#####.###.###.#.#.#########.#####.#.#.#####.#####.#.#.#####.#####.#######.###.#####.###.#.#
#.#.....#.....#.#.#...#...#.#.....#.#.........#...#...#.#.#.....#.#.#.#...#...#.........#...#.#.....#.#...#...#.....#...#.......#.....#...#.#
#.#######.#.#.#.###.#.#####.#####.#.#.#########.###.#.#.#.###.###.#.#.#.#.#.###.#####.###.#.#.###.#.###.###.###.#####.#.#########.#########.#
#.....#...#.#.#.....#.....#.......#.#.....#.....#...#...#.#...#...#...#.#.#.#...#...#.....#...#...#.#...#...#...#.....#.....#.....#.........#
#.###.#####.#.###########.###.#####.#####.#.#####.#######.#.###.###.###.#.#.#.#####.###########.###.#.###.###.###.#########.#.#####.#######.#
#.#.#.#...#.#.............#...#...#...#...#.#.....#.......#...#.....#...#...#.....#...........#.#...#.#...#.#.#.#...#.....#.#...#...#.#.....#
#.#.#.#.#.#######.#############.#.###.#.###.#####.#.#.#######.#######.###########.#.#.#######.#.#####.#.###.#.#.#.#.#.###.#.###.###.#.#.#####
#.#.#...#...#...#.....#.....#...#.....#.#.#.......#.#...#.......#.....#.........#.#.#.....#.....#.....#.#...#.#...#...#.#.#.....#...#.#.....#
#.#.#######.#.#.#####.#.###.###.#######.#.#############.#.#######.#.###.#######.#.#######.#.#####.#####.#.###.#####.###.#.#######.#.#.#####.#
#.#.....#...#.#.....#...#.#...#.....#.#.#.............#.#...#...#.#.#...#...#.#.#.........#.#.#...#.....#...#...#.......#.#.....#.#.#.....#.#
#.#.###.#.###.#####.###.#.###.#.###.#.#.#######.#####.#.###.#.#.#.#.#.###.#.#.#.###########.#.#.###.#####.#.###.#.#.#.###.#.###.#.###.#.###.#
#...#.#.#.....#.....#...#.#...#.#...#...........#...#.#.#...#.#.#.#.#.....#...#.#...........#.#...#...#...#.....#.#.#...#.#.#.#.#...#.#.....#
#####.#.#######.#########.#.###.#.###############.#.#.#.#.###.#.#.#####.#######.#########.###.###.###.#.###########.#####.#.#.#.###.#######.#
#...#...#.....#.........#.#...#.#.....#...#...#...#...#.#.#.#.#.#.....#.#...#...........#.#...#...#...#.#...#.....#.#.....#.#.....#.......#.#
#.###.###.#.#.#########.#.###.###.###.#.###.#.#.#######.#.#.#.#.#.#.###.###.#.#########.#.###.#.###.###.#.#.#.###.###.#####.#####.#####.#.#.#
#...#.#...#.#.....#.....#.......#.#...#...#.#.#.........#...#.#.#.#.....#...#.......#...#.....#.#...#...#.#.#.#.#...#.....#.....#.....#.#.#.#
#.#.#.#.###.#####.#.###########.#.#.###.#.#.#.#######.###.###.#.#.#######.###.#####.#.#######.#.#.#####.#.#.#.#.###.#####.#.###.#####.#.#.###
#.#...#.#.#...#.#.#...#.....#...#.#...#.#...#...#...#.#.....#.#.#...#.....#...#.#...#.......#.#.#.#.....#.#.#.#.#.#.#.....#...#...#...#.#...#
#.#####.#.#.#.#.#.###.#.###.#.#######.#.###.#.#.#.#.#.#.#####.#.#####.#########.#.#######.#.#.#.#.#####.#.#.#.#.#.#.#.#.#####.###.#.#######.#
#.#.......#.#.#.#.#...#.#.#.#.......#.#...#.#.#.#.#.#.#.#...#.#.......#.......#.....#...#.#.#.#.#.#...#...#...#.....#.#.#...#.#.#.#.........#
#.###########.#.#.#.###.#.#.#######.#.#####.#.#.#.#.#.#.###.#.#########.#####.#######.#.#.#.###.#.#.#.#########.#####.#.#.#.#.#.#.#########.#
#...#.........#...#.....#.#...#...#.#.....#.#.#.#.#...#.....#.#.........#...#.#.......#.#.#.....#...#...#.#...#.#.....#.#.#.#...#...#.......#
###.#.#######.#.#########.###.#.#.#.#####.###.#.#.#########.#.###.#.#####.###.#.#######.#.#############.#.#.###.#.###.#.#.#.###.#.#.#.#######
#...#.#...#...#...#.........#.#.#.........#...#.#.#.......#.#.#...#.#.....#...#...#...#.#.....#...#.....#...#...#...#.#.#.#.#...#.#.#.......#
#.###.#.#.#######.#########.#.#############.#####.#.#####.#.#.#.###.#.#####.###.#.#.###.#.###.#.#.#.#####.###.#######.###.#.#####.#.#######.#
#...#...#...#...#...#.....#.#.......#.............#.#...#...#.#.#...#...#...#.#.#.#...#.#.#.....#.#.#.#.......#.....#.....#...#...#.#.#.....#
###.#.#####.###.###.#.###.#.#######.#####.#.#######.#.#.#####.###.#.#.#.#.###.#.#.#.#.#.###.#######.#.#.#######.###.###.#####.#####.#.#.#.###
#.#.#.#...#...#...#...#.#...#...#.#...#...#...#.....#.#.....#...#.#.#.#.#.#.....#.#.#.#...#.#.......#...#.....#...#...#.#...#...#...#...#...#
#.#.#.#.#.###.#.#.#####.###.#.#.#.###.#########.#####.#####.###.###.###.#.#.#####.#.#.###.###.#########.#.###.###.###.###.#.###.#.#.#########
#...#.#.#.#...#.#...#.....#...#.#...#.........#.#...#...#.#...#.#...#...#.#.#.....#.#.........#...#...#.#.#.#.....#...#...#.....#.#.#.......#
###.###.#.#.###.#.###.###.#####.###.#########.#.#.#.###.#.#.#.#.#.###.###.#.#.#################.#.#.#.#.#.#.#######.###.#########.###.#####.#
#...#...#...#.#.#.....#...#...#...#...#...#.#.#.#.#.....#.#.#.#.#.#.....#.#.#...........#.....#.#.#.#.#...#.......#.....#.......#.....#...#.#
#.###.#######.#.#######.###.#.###.#.#.#.#.#.#.#.#.#####.#.###.#.#.#.###.#.#############.#.###.#.#.#.#.#######.###.#######.#######.#####.#.#.#
#.....#.#.....#.#.......#...#...#...#...#...#...#.#...#...#...#...#...#.#.#.....#.......#...#.#.#.#.#...#.....#...#.#.....#.....#.......#.#.#
#######.#.###.#.#.#######.#####.#########.#########.#.#####.#.#########.#.#.###.#.#########.#.#.#.#.#.###.###.###.#.#.###.#.###.#########.#.#
#.....#...#.#...#.........#...#...#.#...#.........#.#.......#...........#...#.#...#.........#...#.#.#.....#.#...#...#...#.#.#.#...........#.#
#.#####.###.###############.###.#.#.#.#.#########.#.###################.#####.#########.#####.###.#######.#.###.#######.#.#.#.#############.#
#.#.....#.#.#.......#...#.#...#.#...#.#.....#...#.#...#.......#.....#.#.#...........#.....#...#.#.#.....#.#...#.........#.....#.......#...#.#
#.#.#####.#.#.#.###.#.#.#.#.#.#.#####.#.#####.#.#.###.#.#####.#.#.#.#.#.#########.#.#####.#####.#.#.###.#.###.#####.###########.#####.#.#.#.#
#...#.....#...#...#.#.#.#...#.#.#.....#.....#.#.#.....#...#...#.#.#...#.....#.....#.#...#...#.#...#.#...#.........#...#...#.....#.....#.#.#.#
#.###.###.#######.#.#.#.#####.#.#.#########.#.#.#########.#.###.#.#########.#.#####.#.#.###.#.#.###.#.#################.#.#.#####.#####.#.#.#
#.....#...........#...#.......#...........#...#...........#.....#.............#.......#.....#.......#...................#...#...........#...#
#############################################################################################################################################
